あまり (amari): so much that
あまりに (amari ni): so much that, too
ばほど (bahodo): the more the more
ばいい (ba ii): should, can, it’d be good if
ばかり (bakari): only, nothing but
ばかりだ (bakari da): continue to
ばかりでなく (bakari denaku): not only but also, as well as
ばかりに (bakari ni): because, on account of
ばよかった (ba yokatta): should have, it would have been better if
べき (beki): must do, should do
べきではない (beki dewa nai): must not do, should not do
べつにない (betsu ni nai): not really, not particularly
中 (chuu): during, throughout
だけ (dake) – 2: as much as
だらけ (darake): covered all over in, full of
どころか (dokoro ka): far from, anything but
どんなにても (donna ni temo): no matter how
ふりをする (furi o suru): to pretend, to act as if
がち (gachi): apt to do, tend to do
がたい (gatai): hard to, difficult to
ぎみ (gimi): -like, -looking
ほど (hodo): the more, to the extent that, so much that
ほどない (hodo nai): is not as as
いくらても (ikura temo): no matter how
一方だ (ippou da): more and more, continue to
一方で (ippou de): on one hand, on the other hand
かけ (kake): half-, not yet finished
から言うと (kara iu to): in terms of, from the point of view of
代わりに (kawari ni): instead of, in exchange for
っけ (kke): what is again?
決してない (kesshite nai): never, by no means
切る (kiru): to do something completely to the end
切れない (kirenai): being too much to finish or complete
きり (kiri): only, just
こそ (koso): for sure (emphasize preceding word)
こと (koto): (must) do
ことだ (koto da): should
ことがある (koto ga aru): there are times when
ことか (koto ka): how! what!
ことから (koto kara): from the fact that
ことに (koto ni): unusually, especially
ことになる (koto ni naru): it has been decided that
ことにする (koto ni suru): to decide on
ことはない (koto wa nai): there is no need to, never happens
くらい (kurai): to the extent that, so that
くせに (kuse ni): even though, and yet, despite
まま (mama): as it is
まるで (maru de): as if, as though
めったにない (metta ni nai): hardly, rarely, seldom
もの (mono): because (indicate reason or excuse)
ものだ (mono da): used to do something, should do something
もしかしたら (moshikashitara): perhaps, maybe
向き (muki): suitable for
向け(muke): intended for, aimed at
ながらも (nagara mo): but, although, despite
ないことはない (nai koto wa nai): can, is not impossible
なんか (nanka): such as, things like
なんて (nante): such as, things like
なぜなら (nazenara): because, the reason is
んだって (ndatte): I heard that
に違いない(ni chigai nai): I’m sure, no doubt that
にかけて (ni kakete): over (a period), through, concerning
に関する (ni kansu ru): related to
に関して (ni kanshite): related to
にかわって (ni kawatte): in stead of, on behalf of
に比べて (ni kurabete): compared to
において (ni oite): in, on, at, as for, regarding
における (ni okeru): in, on, at, as for, regarding
にしては (ni shite wa): for, considering it’s
にしても (ni shite mo): even if
に対して (ni taishite): in contrast to, while, in regard to
にとって (ni totte): to, for, concerning
について (ni tsuite): concerning, regarding
につれて (ni tsurete): as then
によると (ni yoru to): according to
による (ni yoru): by means of, due to
によれば (ni yoreba): according to
によって (ni yotte): by means of, due to
の間に (no aida ni): while, during
をはじめ (o hajime): for example, starting with
おかげで (okage de): thanks to, because of
っぱなし (ppanashi): leaving something on, leaving something still in use
っぽい (ppoi): -ish, -like
さえ (sae): even
さえば (sae ba): if only then
最中に (saichuu ni): in the middle of
せいで (sei de): because of
次第 (shidai): as soon as, dependent upon
しかない (shika nai): have no choice but
その結果 (sono kekka): as a result
そうもない (sou mo nai): very unlikely to
たびに (tabi ni): each time, everytime, whenever
ために (tame ni) 1: for, for the sake of, in order to
ために (tame ni) 2: because of, as a result of
たらいい (tara ii): it would be nice if, should, I hope
といい (to ii): it would be nice if, should, I hope
たとえても (tatoe temo): even if is the case
たとたん (ta totan): just (now, at the moment), as soon as
てごらん (te goran): (please) try to, (please) look
てはじめて (te hajimete): not until, only after did I
てもかまわない (temo kamawanai): it doesn’t matter if
といっても (to itte mo): although I say, although one might say
という (to iu): called, named, as much as
ということだ (to iu koto da): I’ve heard that, rumour has it that
というのは (to iu nowa): means, is, because
というと (to iu to): speaking of, if it were the case that
というより (to iu yori): rather than
ところで (tokoro de): by the way
ところが (tokoro ga): even so, however, even though
とおり (toori): in the way, the same as
としたら (to shitara): if it were the case that, if we assume
とすれば (to sureba): if it were the case that, if we assume
として (to shite): as (i.e. in the role of)
とは限らない (towa kagiranai): not necessarily so, is not always true
ついでに (tsuide ni): while you are at it, on the occasion
つまり (tsumari): in other words; that is to say
と共に (to tomo ni): together with
うちに (uchi ni): while, before, doing
上で (ue de): after
わけだ (wake da): for that reason, no wonder, as you’d expect
わけではない (wake dewa nai): it doesn’t mean that, it is not the case
わけがない (wake ga nai): there is no way that
わけにはいかない (wake niwa ikanai): must not, can’t afford to
わりに (wari ni): although, rather, unexpectedly
ような気がする (you na ki ga suru): have a feeling that, think that
ように (you ni): in order to, so that
ようとする (you to suru): try to, be about to
ようとしない (you to shinai): not try to, not make an effort to
ずに (zuni): without doing
ずにはいられない (zu niwa irarenai): can’t help but feel, can’t help but do
あるいは (aruiwa): or, possibly
ばかり (bakari) – 2: about, approximately
ぶりに (buri ni): for the first time in
ちっともない (chitto monai): not at all, not in the least
だけあって (dake atte): being the case, precisely because
だけでなく (dake de naku): not only but also
だけましだ (dake mashi da): one should feel grateful for
だけに (dake ni): being the case, precisely because
だけのことはある (dake no koto wa aru): no wonder, it’s not surprising that
だけは (dake wa): to do all that one can
だって (datte): because, but
ではないか (dewa nai ka): let’s do something, why don’t we
でしかない (de shika nai): merely, nothing but, no more than
どころではない (dokoro dewa nai): this is not the time for
どうせ (douse): anyway, anyhow
どうやら (dou yara): it seems like, it appears that
える(eru): can, is possible
うる (uru): can, is possible
えない (enai): unable to, cannot
ふたたび (futatabi): again, once more
ふうに (fuu ni): in a way,this way,that way,what way
げ (ge): giving the appearance of
ごとに (goto ni): each, every, at intervals of
逆に (gyaku ni): on the contrary
以外 (igai): excepting, with the exception of
いよいよ (iyoiyo): at last, finally
反面 (hanmen): on the other hand
果たして (hatashite): sure enough, really
以上 (ijou): because, now that
以上に (ijou ni): more than, no less than
いきなり (ikinari): suddenly, all of a sudden
いわゆる (iwayuru): so-called, so to speak
上 (jou): from the standpoint of
かないかのうちに (kanai ka no uchi ni): right after, as soon as
かえって (kaette): on the contrary, rather, surprisingly
かいがある(kai ga aru): it’s worth one’s effort to do something
か何か (ka nanika): or something
かねない (kanenai): might happen, might do something
かねる (kaneru): unable to do something
かのよう (ka no you): as if, just like
からこそ (kara koso): precisely because
から見ると (kara miru to): from the point of view of, by the look of
からには (kara niwa): now that, since, so long as
からして (kara shite): judging from, based on
からすると (kara suru to): judging from, considering
からすれば (kara sureba): judging from, considering
からといって (kara to itte): just because
かと思ったら (ka to omottara): then again, just when, no sooner than
かと思うと (ka to omou to): then again, just when, no sooner than
限り (kagiri): as long as, while is the case
気 (ki): feel like
っこない (kkonai): no chance of, is definitely not possible
ことだから (koto dakara): it is exactly because
ことなく (koto naku): without doing something even once
ことになっている (koto ni natte iru): to be expected to, to be scheduled to
ことにはならない (koto niwa naranai): just because doesn’t mean
ことはが (koto waga): although, but
まい (mai): won’t, intend not to
まったくない (mattakunai): notat all
もばも (mobamo): and
もかまわず (mo kamawazu): without worrying about
ものだから (mono dakara): because, the reason is
ものではない (mono dewa nai): shouldn’t do something, it’s impossible to do something
ものがある (mono ga aru): [sentence-ending expression of strong judgement]
ものか (mono ka): as if
ものなら (mono nara): if one can do something
ものの (mono no): but, although
もっとも (motto mo): but then, although
もう少しで (mou sukoshi de): almost, nearly
むしろ (mushiro): rather, instead
中を (naka o): in, on
なお (nao): furthermore, still, yet [used to add more information to the sentence]
ないではいられない (nai dewa irarenai): can’t help but feel, can’t help but do
ないことにはない (nai koto niwanai): unless you do something
なくはない (naku wa nai): it’s not that, can, may be
なにもない (nani monai): no need to
ねばならない (neba naranai): have to, must
にあたり (ni atari): at the time, on the occasion of
に反して (ni han shite): against, contrary to
にほかならない (ni hoka naranai): nothing but, none other than
に限って (ni kagitte): only, particularly when
に限らず (ni kagirazu): not just, not only but also
に限る (ni kagiru): nothing better than, there’s nothing like
にかかわる (ni kakawaru): to relate to, to have to do with
にかかわらず (ni kakawarazu): regardless of
に決まっている (ni kimatte iru): I’m sure that
に越したことはない (ni koshita koto wa nai): it’s best that, there’s nothing better than
に応えて (ni kotaete): in response to
に加えて (ni kuwaete): in addition to
に基づいて (ni motozuite): based on
にもかかわらず (nimo kakawarazu): despite, in spite of, although
に向かって (ni mukatte): towards, to face, to head to
に応じて (ni oujite): depending on, in accordance with
に際して (ni sai shite): on the occasion of, at the time of
に先立ち (ni sakidachi): before, prior to
にしろ (ni shiro): though, even if, whether or
にせよ (niseyo): though, even if, whether or
にしろにしろ (ni shironi shiro): whether or
に従って (ni shitagatte): as, therefore
にしたら (ni shitara): from the point of view of
にしてもにしても (ni shite moni shite mo): regardless of whether
に相違ない (ni soui nai): without a doubt, certain, sure
に沿って (ni sotte): along with, in accordance with
に過ぎない (ni suginai): no more than, just, merely
にて (nite): in, at
に伴って (ni tomonatte): as, due to
につけ (ni tsuke): both and, every time something happens
につき (ni tsuki): due to, because, per, each
には (niwa): in order to, for
にわたって (ni watatte): throughout, over (a period of time)
のももっともだ (no mo mottomo da): no wonder, is only natural
のも当然だ (no mo touzen da): it’s only natural that, no wonder
のもとで (no moto de): under
のみならず (nominarazu): not only, besides, as well
抜きで (nuki de): leaving out, cutting out
抜きにして (nuki ni shite): leaving out, cutting out
抜く (nuku): to do something to the end
お願う (onegau): could you please
をとして (oto shite): as
を中心に (o chuushin ni): focused on, centered on
をこめて (o komete): filled with
をきっかけに (o kikkake ni): with as a start, as a result of
を契機に (o keiki ni): as a good opportunity to, as a result of
をめぐって (o megutte): concerning, in regard to
をもとに (o moto ni): based on, from
を除いて (o nozoite): except, with the exception of
を問わず (o towazu): regardless of
を通じて (o tsuujite): via, through
を通して (o tooshite): via, through
おまけに (omake ni): to make matters worse
おそらく (osoraku): perhaps, likely, probably
恐れがある (osore ga aru): there are fears that
ろくにない (roku ninai): not doing something properly
際に (sai ni): at the time, in case of
幸い (saiwai): luckily, fortunately
さらに (sara ni): furthermore, again, more and more
せいぜい (seizei): at the most, at best
せめて (semete): at least, at most
次第だ (shidai da): depending on, so
次第で (shidai de): depending on, so
しかも (shikamo): moreover, furthermore
したがって (shitagatte): therefore, accordingly
その上 (sono ue): besides, in addition, furthermore
それなのに (sore na noni): and yet, despite this
それなら (sore nara): then, if that’s the case
それにしても (sore ni shite mo): nevertheless, even so
それとも (sore tomo): or, or else
そういえば (sou ieba): come to think of it
そうにない (sou ni nai): extremely unlikely to, showing no signs of
そうすると (sou suru to): having done that
少しもない (sukoshi monai): not one bit, not even a little
すなわち (sunawachi): in other words
たあげく (ta ageku): to end up, finally
直ちに (tadachi ni): at once, immediately
た結果 (ta kekka): as a result of
の結果 (no kekka): as a result of
たまえ (tamae): [order somebody to do something]
た末 (ta sue): as a conclusion of
の末 (no sue): as a conclusion of
確かに (tashika ni): surely, certainly
たって (tatte): even if, even though, no matter how
たとえば (tatoeba): for example
たところで (ta tokoro de): even if one does something
てばかりはいられない (te bakari wa irarenai): can’t keep doing something
てでも (te demo): even if one has to, by all means
て以来 (te irai): since
ていては (te ite wa): if one keeps doing something
てからでないと (te kara denai to): unless, until
てこそ (te koso): now that, since
手前 (temae): before, in front of, from one’s standpoint
てならない (te naranai): very, extremely
てしょうがない (te shou ga nai): very, extremely
てたまらない (te tamaranai): very, extremely, can’t help but do
て当然だ (te touzen da): natural, as a matter of course
ては (tewa): if, since, one after another
てはいられない (tewa irarenai): can’t afford to, unable to
てはならない (tewa naranai): must not, cannot, should not
途中に (tochuu ni): on the way, in the middle of
途中で (tochuu de): on the way, in the middle of
と同時に (to douji ni): at the same time as
というふうに (to iu fuu ni): in such a way that
ということは (to iu koto wa): that is to say
というものだ (to iu mono da): something like, something called
というものでもない (to iu mono demo nai): there is no guarantee that, not necessarily
といった (to itta): such as
とか (toka): I heard that
と考えられる (to kangaerareru): one can think that
ところだった (tokoro datta): was just about to do something
ところに (tokoro ni): at the time
ところへ (tokoro e): at the time
ところを見ると (tokoro o miru to): judging from, seeing that
とっくに (tokku ni): already, long ago
とも (tomo): even if, no matter
としても (to shite mo): assuming, even if
としては (toshite wa): as for
つもりで (tsumori de): with the intention of doing
つつ (tsutsu): while, although
つつある (tsutsu aru): to be doing
上に (ue ni): as well, besides, in addition to
上は (ue wa): now that, since
は別として (wa betsu to shite): aside from
はもとより (wa moto yori): also, let alone
はともかく (wa tomokaku): whether or not
わずかに (wazuka ni): slightly
やがて (yagate): soon, before long, eventually
やらやら (yarayara): such things as
よりほかない (yori hoka nai): to have no choice but
ようでは (you dewa): if
ようがない (you ga nai): there’s no way to, it’s impossible to
ようもない (you mo nai): there’s no way to, it’s impossible to
要するに (you suru ni): the point is
ざるを得ない (zaru o enai): can’t help doing, have no choice but
ずに済む (zu ni sumu): get by without doing something
